111111111111111111111111111111111111111111111111111111111111
1000000001C011C00000000000000000011100000000000000000C01P001
100000000100110000000000000000000001000000000000000000010001
1C0000000100110000000000000000000001000000000000000000000011
100000001000111111111100000000000001111111111111111111100011
100000001000110000000000000000000000000000000000000000000011
100000111001110000000000000C00000001100000000000000000000011
100001000011111111111111111111111111100000000000000000000011
100000000000000100000000000000000001100001111111111111110011
100000000000110110000000000000000001100111000000000000000011
100111111000100000000000000000000001100111000000000000000011
100000C01000100000000000000000000000000111000000000000000011
100000001000100000000000000000000011111111111111111111111011
100000001000100000000000000011111110000000000000111C00000001
1000000010001000000001111111111C0000000000000000001001000001
10000001000000000011111C000001000000001000000000001111100001
100001111111111111100000000001000000000000000000000000110001
100000000001100001111000C00011000000001000000000000000000001
111000011000110000001111100001000000000010000000000000000001
111100011100010000001100000000000000000000000000000000000001
111111111111011111111111111111111111111111111111111111111101
1000C10000000000100000001001100000000000000000100000000000C1
100001000000000000111010001110000001000000000010000000000001
100111000000000001111C10000000000000000000000010011111111001
100000000000000011111110001111000001000000000010010000001001
1000000000000010000110001000110000000000000000100100000C1001
100000000000000000010000010011000000100000000010010000001001
100000000000001000010000000000010000000000000000010000000001
101111100001111111111111111111111111111111111111111111110111
10000011000C100000000000000001C00100000000001000001111110111
100000111111100000000000000001000100000000100000000000000001
100000000000000000000001000000000000001000000000000000000CE1
111111111111111111111111111111111111111111111111111111111111