1111111111111111111111111111111111111111111111111111111111111111111111111111
1000000001C000000000000000000000000000000000000000000C0000000000000000000011
1000000000000100000000001000000000000000000000000000000000000000000000000011
1C00000001001000000000000000000000000000000000000000000000000000000000000011
1000000001000000000000000000000000001111111111110000000000000000000000000001
1000000001000000000000000000000000000100000000010000000000000000000000000001
1000000010000000111110000000000000000000000000000000000000000000000000000011
1000000011110000000000000000000000001111111111000000000000000000000000000001
1000010000000001000000000000000000011001111000000000000000000000000000000001
1000011111111000000001000000000000000000001111000000000000000000000000000001
1001110000001000000000000000000000000000000000000000000000000000000000000001
100000000C000000000000000000P00000000000000000000000000000000001000000000001
1000000010000000000001000000000000000000001111110000000000000000000000000001
1000000010000000000001110000000000000001111000000000000000000000000000000001
1000000010000000001111111000000000000000000001000000000000000000000000000001
1000000100000000000000000001000000000000000001000000000000000000000000000001
1000000011110000000001000000000000000000000000000000000000000000000000000001
1000000000001111111110000000000000001110000000000000000000000000000000000001
1000000000000000001000000000000000000000000000000000000000000000000000000001
1001111111111000001111000000000000000000000000000000000000000000000000000001
100000C100100000000000100000000000000000000000000000000000000110000000000001
1000000000001000000001000000000000000000000000000000000000000000000000000001
1000000000001000000001000000000000001000000000000000000000000000000000000001
1000000011000000001000000000000000000000000000000000000000000000000000000001
1000000000000000000001000000000000000000000000000000000000000000000000000001
1000011111110000000000000000000000000000000000000000000000000000000000000001
1000000000000000000000000001111111111000000000000000000000000000000000000001
1000000000001111111111000000000000000000000000000000000000000000000000000001
1001111111110000000000000000000000000000000000000000000000000000000000000001
1000001000000000000000000000000000001000000000000000000000000000000000000001
1000001110000000000000000000000000000000000000000000000000000000000000000001
1000001110000000000000000000000000000000000000000000000000000000000000000001
1000000001111110000000000000000000000000000000000000000000000000000000000001
1000000000000000000000000000000000000000000000000000000000000000000000000001
100000001C111111000000000000000000000000000000000000000000000000000000000011
1000010000000001000000000000000000000000000000000000000000000000000000000011
1000010000000001000000000000000000000000000000000000000000000000000000000011
1001110000000001000000000000000000000000000000000000000000000000000000000E11
1111111111111111111111111111111111111111111111111111111111111111111111111111
