1111111111111111111111111111
100000000000000C00000C100001
1010010100100000101001000001
1010010010101010001001000001
100000000C00C00000P0000000E1
1011111111111111111111111111
100000000C00C000000000000011
1111111111111111111111111111