1111111111111111111111111111111111
100000000000000C00000C000000000001
1010010100100000101001000P00010101
1010010010101010001001000000010111
100000000C00C0000000000000E00000C1
1000000000000000000000000000000001
1000000000000000000000000000000001
1000000000000000000000000000000001
1000000000000000000000000000000001
1000000000000000000000000000000001
1000000000000000000000000000000001
1000000000000000000000000000000001
1000000000000000000000000000000001
1111111111111111111111111111111111
