1111111111111111111111111111
100000000000000C00000C100001
1010010100100000101001000001
1P01001001010101000100100011
100000000C00C0000000000000E1
1011111111111111111111111111
100000000C00C000000000000011
1111111111111111111111111111