111111111111111111111111111111111111111111111111111111111111111111111111111111111111111111111111111
1000MM0000000000000000000000M0000000000000000000000000000000000000000000000000000000000000000000001
100111100000000000000000000000000000000000000000000000000000000000000000000000000000000000000000001
101100011000000000000000000000000000000000000000000C00000000000000000000000000000000000000000000001
101000001000000000000000000000000000000000000000001111000000000000000000000000000000000000000000001
101E0000000C000000000000000000000000000000000000000100000000000000000000000000000000C0000M000000001
111111111111100110000000000000000000000000000000000000111110000000000000000000000011111100000000001
1M1111100000000000000111000000000000000000000000000000011111100011110011000000001111111111100000001
100110000000000001111111100000000000000000000000000000001100000111111111100000000111111100000011001
100000000000000000011000000000000000000000000000000000000000000000011000000000000000111000000000001
100000000111111110000000000000000000000000000000000000000000000000000000000000000000000000000000001
111111000000111100000000000000000000000000000000000000000000000000000000000000000000000000000000011
110011100000000000000000000000000000000000000000000000000000000000000000000000000000000000000000001
100C0000111110000000000000000000000000000000000000M000000000000000000000000000000000000000000011001
111111111100000011000000000000000000000000000000000000000000000000000000000000000000000000000000001
111111110000000011100000000000000000000000000000000000000000000000011111100000000000000000000000011
111100000000000000000000000000000000000000000011111111000000000000111111111000000000000000000000001
100000000000000000011000000000000000001111111111111111111111111111111111111111111111111111110000111
100000000000000000111111000000000000000000111111111111111111111111111111111111111111111111111100001
100000000000000000001100000000011110000000000000001111110000000111111111111111110000000000000001111
1000000000000000000000000111111111111100000000000000100000000000000011111111100000000000001100000C1
100000000000000000000000000011111000000000000000000000000000000000000011000000000000000001111111111
100000000000000000000000000000000000000000000000000000000000000000000000000000000111000000000000001
100000000000000000000000000000000000000000000000000000000000000000000000000000000000000000000000001
100000000000000000000000000000000000000000000000000C00000000000000000000000001111000000000000000001
100000000000000000000000000000000000000000000000011111000000000000000000000000100000011100011000001
100000000000000000000000000000000000000000000001110001110000000000000000000000000000000000000000111
110000000000000000000000000000000000001100000011000000011000000000000000000000000000000000001111111
111000000000000000000000000001111100000000000110000000001100000000000000000000000011111111111111111
111000000000000000111100000000001000000000001100000000000110000000000000000111110000001111111111111
11111C000001110000011000000000000000000000000000000000000000000000000000011111000000000000001111111
111111111000000000000000000000000000000000111110000000000011100000011110000000000000000000000000001
111111111111111111111111111110000000000000001000001110000010000000000000000000000000000000000000001
111111111111110000000000111100000000000000001000000000011110000000000000000000000000000000000000001
111111000000000000000M000010000000000000000010C0000111000010000000000000000000000000000000000000001
100000000000000000000000000000000000000000001111000000000010000000000000000000000000000000000000001
100000000000000000000000000000000000000000001000000000000010000000000000000000000000000000000000001
100000000000000000000000000000000000000000000000000000000000000000000000000000000000000000000000001
1000000000000000000000000000000C0000000011111111111111111111111000000000000000000000000000000000001
100000000000000000000000111111111111000000111111111111111111110001111000000000000000000000000001111
10000000000000000011110000011111000000000000000110M1111100000000000110000000000000000000M0011111111
100000000000000000011000000000000000000000000011100000000000000000000111100000000000000000110000001
100P00000011100000000M000000M000000000000000011110000C0000000000000000000000000000000000000000000C1
111111111111111111111111111111111111111111111111111111111111111111111111111111111111111111111111111
