1111111111111111111111111111
100000000000000C00000C100001
1010010100100000101001000001
1001001001010110001001000111
100000000C00C0000000000000P1
1011111111111111111111111111
100000000C00C000000000000E01
1111111111111111111111111111
